....B..5.D...4E.
...6.0..7...3.B.
C.5..9.26...7FA.
...1.64..3BE.0..
...C13D7B029.A..
2.....E..6.F.5C.
....C..B.EA...0.
7.8.0....C..F...
...0..B....5.E.6
.6...5A.1..3....
.14.2.C..8.....F
..D.6F0E2A47B...
..A.8C2..53.E...
.ECF...0A.6..D.9
.4.D...3..E.1...
.01...6.4..B....
